11111111111111111111111111
10001000000000000000000001
10P00001000000000000000001
10011000000101110000001001
10000000000100000000110001
10011000000101110000110001
10000000000100000000111101
10011000000101110000000001
10000000000100000000011001
10011000000101110000001001
10000000000100000000000001
11111111111111111111111111