
                  
F		+252, 255,+255           
WE        textures/bluestone.xpm
   



						
NO                 textures/hitler.xpm

    SO       textures/colorstone.xpm



EA                  textures/hanaf2.xpm

C 220, 10, 55           


11111111111111111111111111
10001000000000000000000001
10000001000000000000000001
10011000000101110000001001   111111
10000000000100000000110001   100001
10011000000101110000110001   10N001
10000000000100000000111101   111111
100110000001011100000000011
10000000000100000000110011                                         
100000000001000000000000011
11111111111111111111111111
11111111111111111111111111
10001000000000000000000001
10000001000000000000000001
10011000000101110000001001
10000000000100000000110001
10011000000101110000110001
10000000000100000000111101
10011000000101110000000001
10000000000100000000011001
10011000000101110000010001
10000000000100000000000001
11111111111111111111111111



