   
NO                 textures/hitler.xpm

SO   textures/hitler.xpm

WE        textures/hitler.xpm


EA     textures/hitler.xpm

F 220           ,      231      , 0

    C   225,9,30                                                          





11111111111
11000010001
100N00010001
11111111111                                                                            

 1           
1S11
 111