
F		252, 255,255           
WE        textures/tex2.xpm

						
NO                 textures/tex4.xpm

    SO       textures/tex1.xpm



EA                  textures/tex3.xpm

C 220, 10, 55          


11111111111111111111111111
10001000000000000000000001
10011000000101110000001001   
10000001000000000000000001
10000000000100000000110001  
10011000000101110000110001 
1000000N000100000000111101
10011000000101110000000001
10000000000100000000110011                                         
10000000000100000000000001
11111111111111111111111111
11111111111111111111111111
10001000000000000000000001
10000001000000000000000001
10011000000101110000001001
10000000000100000000110001
10011000000101110000110001
10000000000100000000111101
10011000000101110000000001
10000000000100000000011001
10011000000101110000010001
10000000000100000000000001
11111111111111111111111111



