   



						
NO                 textures/hitler.xpm

SO   textures/hitler.xpm

WE        textures/hitler.xpm


EA     textures/hitler.xpm

F 220    			    ,      231      , 0

    C   225,9,30                                                          





11111111111111111111111111
10001000000000000000000001
11N10001000000000000000001
11111000000101110000001001
10000000000100000000110001
10011000000101110000110001
10000000000100000000111101
10011000000101110000000001
10000000000100000000011001
10011000000101110000001001
10000000000100000000000001
11111111111111111111111111