1111111111111111111111111111111
1100000010000101011001111111111
1000000000000000001100000111111
1000000000000000000011110111111
1000000000000000111100000111111
1000000000011110000000000111111
1000000011000000000000000111111
1000111100000000000000000111111
1111111111111111111111111111111
